 ---   ---
 -A-   -O-
--X----- -
-        -
-  ----  -
----------