      -----   
      -   ----
      -    O -
      -- -----
-------- -    
-A X     -    
-------  -    
      ----    