      -----   
      -   ----
      -    O -
      -  -----
-------- -    
-  X  A  -    
-------  -    
      ----    